1111111111111111111111111
10000C000101101000C000001
100EP00010001010000110001
11110000C0011000000110001
11110000C0010000000000001
11110000C0010000000110001
11110000C0011000000110001
100C011C1C000000000000001
100C01111C000000000000001
100C01111C001100000000001
1111111111111111111111111
