11111111111
100C00010E1
10P00010001
111100C0001
100C011C001
11111111111