11111111111
10L00000001
11111111111