1111111111111
10110C00010E1
1000P00010001
11110000C0001
100C01111C001
1111111111111
